

1111111111111111111111111111111111
100000000000000C00000C000000000001
1010010100100000101001000000010101
10100100101010100010010000K0010101
100000000C00C0000000000000000000C1
100000K000000000000000000000000001
1000000000100000E00000000000010001
10000010000100C0000000000010000001
100001C000001000000000000100000001
1000001000000000000000000100000001
1000000000000000000000C0K000000001
1P10000000000000000010000100000001
1111111111111111111111111111111111

